{
    "width": 20,
    "height": 20,
    "tileWidth": 64,
    "tileHeight": 64,
    "layers": [
        {
            "name": "ground",
            "data": [
                19, 19, 19, 19, 19, 19, 19, 19, 19, 19, 19, 19, 19, 19, 19, 19, 19, 19, 19, 19,
                19, 1, 1, 1, 1, 1, 1, 1, 1, 1, 1, 1, 1, 1, 1, 1, 1, 1, 1, 19,
                19, 1, 1, 1, 1, 1, 1, 1, 1, 1, 1, 1, 1, 1, 1, 1, 1, 1, 1, 19,
                19, 1, 1, 1, 19, 19, 19, 1, 1, 1, 1, 1, 1, 1, 1, 1, 1, 1, 1, 19,
                19, 1, 1, 1, 19, 19, 19, 1, 1, 1, 1, 1, 1, 1, 1, 1, 1, 1, 1, 19,
                19, 1, 1, 1, 19, 19, 19, 1, 1, 1, 1, 1, 1, 1, 1, 1, 1, 1, 1, 19,
                19, 1, 1, 1, 19, 19, 19, 1, 1, 1, 1, 1, 1, 1, 1, 1, 1, 1, 1, 19,
                19, 1, 1, 1, 19, 19, 19, 1, 1, 1, 1, 1, 1, 1, 1, 1, 1, 1, 1, 19,
                19, 1, 1, 1, 19, 19, 19, 1, 1, 1, 1, 1, 1, 1, 1, 1, 1, 1, 1, 19,
                19, 1, 1, 1, 19, 19, 19, 1, 1, 1, 1, 1, 1, 1, 1, 1, 1, 1, 1, 19,
                19, 1, 1, 1, 19, 19, 19, 19, 19, 19, 19, 1, 1, 19, 19, 19, 19, 19, 19, 19,
                19, 1, 1, 1, 1, 1, 1, 1, 1, 19, 19, 1, 1, 19, 19, 19, 1, 1, 1, 19,
                19, 1, 1, 1, 1, 1, 1, 1, 1, 19, 19, 1, 1, 19, 19, 19, 1, 1, 1, 19,
                19, 1, 1, 1, 19, 19, 19, 19, 19, 19, 19, 1, 1, 19, 19, 19, 1, 1, 1, 19,
                19, 1, 1, 1, 1, 1, 1, 1, 1, 1, 1, 1, 1, 1, 1, 1, 1, 1, 1, 19,
                19, 1, 1, 1, 1, 1, 1, 1, 1, 1, 1, 1, 1, 1, 1, 1, 1, 1, 1, 19,
                19, 1, 1, 1, 19, 19, 19, 19, 19, 19, 19, 19, 19, 19, 19, 19, 1, 1, 1, 19,
                19, 1, 1, 1, 1, 1, 1, 1, 1, 1, 1, 1, 19, 19, 19, 19, 1, 1, 1, 19,
                19, 1, 1, 1, 1, 1, 1, 1, 1, 1, 1, 1, 19, 19, 19, 19, 1, 1, 1, 19,
                19, 19, 19, 19, 19, 19, 19, 19, 19, 19, 19, 19, 19, 19, 19, 19, 19, 19, 19, 19
            ]
        }
    ]
}